przyjąć do wiadomości	- Nasi koledzy nie chcą przyjąć do wiadomości , że jest inaczej , niż miało być . . .
staną przed sądem	Były szef szamotulskiej prokuratury , pani prokurator i pracownica sekretariatu prokuratury staną przed sądem za ukrywanie dokumentów i fałszowanie statystyk .
przyszedł na świat	22 . 05 . 1859 przyszedł na świat Conan Doyle , który stworzył Sherlocka Holmesa .
Bierzemy pod lupę	- Bierzemy pod lupę firmy handlujące długami szpitali - zapowiedział minister zdrowia Mariusz Łapiński .
usiedzieć na miejscu	- Bardzo dobry człowiek - odpowiedział gorąco i patrzył na Zośkę , która nie mogła usiedzieć na miejscu , wyręczyła Jaskólską w nalewaniu herbaty , pooglądała książki leżące na starej komodzie , podkręciła lampy , obejrzała szydełkową serwetę , jaką była nakryta maszyna do szycia , przygładziła dzieciom włosy i kręciła się po izbie jak fryga .
weszła w życie	Najnowsza ustawa , która weszła w życie w maju 2004 roku , precyzuje zasady udzielania tego typu pomocy oraz kryteria dochodowe , które muszą być spełnione , ale była ona bezpłatna - wyjaśnia Magdalena Gościniewicz , zastępca dyrektora Miejskiego Ośrodka Pomocy Rodzinie w Kielcach .
wchodzących w skład	Trwają już negocjacje z prezesami spółek wchodzących w skład ŚFUP-u .
robiące na drutach	Z nastaniem późnojesiennych chłodów na targu pojawiły się kobiety robiące na drutach bądź dziergające na szydełku z grubej włóczki skarpety lub papcie .
doszli do wniosku	Dopiero 3 kwietnia 1968 roku w Duke University , Irwin Fridovich i Joe McCord badający redukcję cytochromu c przez oksydazę ksantynową doszli do wniosku , że redukcja ta nie jest następstwem bezpośredniego kontaktu obu białek , lecz zachodzi za pośrednictwem uwalnianego przez oksydazę ksantynową wolnego rodnika - anionorodnika ponadtlenkowego .
zwrócił się z prośbą	Darek P . widząc , że jego zeznania nie przyniosły żadnego skutku , a Komor chodzi na wolności , sprzedaje majątek i dalej prowadzi swoje lewe interesy , zwrócił się z prośbą o pomoc do dziennikarzy .
dają się we znaki	Do 23 wzrosła wczoraj liczba ofiar śmiertelnych ulewnych deszczów , które od kilku dni dają się we znaki mieszkańcom południowo - zachodniej Japonii .
pozostawione same sobie	Tak do końca nie byłem był em tego pewien : co jak co , ale paliwa rakietowe wydzielają ogromną ilość energii i chyba byłyby były by w stanie , odpowiednio długo pozostawione same sobie , przepalić cienki w tym miejscu pancerz .
staniesz po stronie	Głos wywróżył , że w pracy " staniesz po stronie przełożonych " .
wpadam na pomysł	Ale nie widzę , więc wpadam na pomysł , by zresetować swój telefon .
ma do czynienia	TP chce więc od razu przetestować w sądzie , czy ma do czynienia z organem właściwie umocowanym , czy też nie .
wejdą w życie	Jednak zmiany , jeśli zostaną zaakceptowane przez Sejm , a później Senat i prezydenta , wejdą w życie najwcześniej za półtora roku .
miał niewyparzony język	Facet był najwyraźniej nieco konfliktowy , miał niewyparzony język , więc mógł kiedyś powiedzieć słowo za dużo .
jesteśmy w stanie	Jednak na podstawie dostępnych faktów wciąż nie jesteśmy w stanie powiedzieć , jakie były motywy uprowadzenia , dopóki porywacze się z nami nie skontaktują .
zdecyduje się udzielić kredytu	( Plafon oznacza , że rządowy ubezpieczyciel kredytu - w tym wypadku COFACE - udzieli gwarancji , o ile któryś z dwóch banków francuskich , z jakimi zawarł umowy Bank Handlowy , zdecyduje się udzielić kredytu ) .
dojść do wniosku	Porównując tempo sprzedaży krajowej z tempem eksportu można jedynie dojść do wniosku , iż wpływ eksportu na wzrost sprzedaży ogółem w krajach Unii był w WP jedynie nieco większy niż w MSP .
postawione w stan	Inne - kupione - zostały postawione w stan likwidacji .
będzie w stanie	Określeń jest wiele - pluskwa milenijna , problem roku 2000 ( PR 2000 ) , Y2K - ale wszystkie oznaczają jedno : o północy z 31 grudnia 1999 na 1 stycznia 2000 wiele setek milionów urządzeń elektronicznych na całym świecie może przestać działać , bo nie będzie w stanie poprawnie odczytać daty .
doprowadzać do rozpaczy	Z drugiej strony , wódz armii nacierającej miał wówczas dylemat , gdyż ta sama doktryna pouczała , żeby nie doprowadzać do rozpaczy słabszego nieprzyjaciela , zamykając mu wszystkie drogi odwrotu , bo wówczas budzi się w nim lew i może okazać się silniejszy .
ma podpisane umowy	Szpital , znany ze swej działalności w całej Polsce , ma podpisane umowy o udzielanie świadczeń zdrowotnych z kasami chorych : zachodniopomorską , branżową i lubuską .
wejściu w życie	Po wejściu w życie nowego prawa dewizowego , przedsiębiorstwa będą mogły kupować lub sprzedawać za granicą za złote .
oddanie do użytku	Mimo że budowa nowogardzkiego " Orlika " zakończyła się jeszcze w lipcu , oficjalne oddanie do użytku nastąpiło w miniony poniedziałek .
mające na celu	Spotkania , mające na celu właściwe przygotowanie się do rewitalizacji odbywają się cyklicznie we wszystkich miastach Polski , które przygotowują się do tego procesu .
starano się pogodzić	Drużyna wygrała rozgrywki NBA zaledwie w rok po okresie wrzawy , kiedy to starano się pogodzić z dominującą obecnością supergwiazdy Michael Jordana , a on sam borykał się z tym , w jaki sposób grać z mniej utalentowanymi kolegami klubowymi .
szansę wykazania się	Daje on młodym ludziom szansę wykazania się umiejętnościami organizatorskimi .
cierpiącego na zaburzenia	Z tego typu zaufania pacjenta cierpiącego na zaburzenia erekcji wyłączone są jednak pielęgniarki .
Wyszło na jaw	Wyszło na jaw , że pracownicy działów mieli powód , żeby nas lekceważyć , każdy z nich zarabiał oczywiście na kolejny punkt w swoim CV , co warte było uwagi , tyle że musiały ich utrzymywać jakieś matki czy ciotki albo chodzili do pracy na piechotę , albo jedli w kółko suchary .
nie ma mowy	Po trzecie , nie ma mowy o jakichkolwiek negocjacjach politycznych , a jedynie o warunkach powrotu Maschadowa do życia w warunkach pokojowych .
wchodziła w życie	Gdy wchodziła w życie reforma edukacji , Jerzy Buzek otwierał rok szkolny i prezentował gimbusy .
mającą na celu	Zatem " określenie " Namiestnik Chrystusa " . . . wskazuje nie tyle na godność , co na służbę : pragnie podkreślić zadanie Papieża w Kościele , jako posługę Piotrową , mającą na celu dobro Kościoła i wiernych " .
dojście do głosu	Okres andrzejkowych wróżb jest takim właśnie okresem , gdzie każdy może sobie pozwolić na dojście do głosu tego " pierwotnego człowieka " w sobie , bez obaw , że zostanie to źle przyjęte . . .
wyrzucił z siebie	- To syn mój - wyrzucił z siebie ojciec , niczym nowinę .
nie ma co	Ale nie ma co ukrywać : islam jest religią patriarchalną .
jesteśmy w stanie	76-letni dziś twórca ma coraz mniej wiary w człowieka : " Nie jesteśmy w stanie utrwalić żadnych wartości , zachowań ani stereotypów .
doszedł do wniosku	Po czterech latach doszedł do wniosku , że rzeczy , które można kupić , dzielą się na dobre , bardzo dobre i świetne .
przyszło na świat	Dlatego właśnie tam przyszło na świat „ milenijne dziecko " .
bazgrała jak kura pazurem	Sama bazgrała jak kura pazurem i ojciec strofował ją żartobliwie za brak staranności .
na własne oczy widział	Mieszkał em naprzeciwko , na własne oczy widział em , co się tam działo .
mają we krwi	Będą nam za to służyły , jak to mają we krwi , oczyszczając nasze otoczenie z gryzoni .
chcąc nie chcąc	Ale w pracy często mi się winda psuje , więc , chcąc nie chcąc , biegając po schodach , dbam o linię .
spędzała sen z powiek	Przez dwa lata działalność 43-letniego szantażysty spędzała sen z powiek niemieckim konsumentom .
działać na szkodę	Bezpośrednimi beneficjentami dobrych praktyk są oczywiście akcjonariusze , którzy dzięki nim zyskują większą pewność , że inni udziałowcy lub menedżerowie nie będą działać na szkodę przedsiębiorstwa .
mieli za zadanie	Informacje zbierali pracownicy , którzy mieli za zadanie obejść wszystkie ulice miasta i odwiedzić każdą firmę , jaka się przy nich znajduje .
ruszyli w drogę	Posilili się i znów ruszyli w drogę , ale wnet opanowało ich takie znużenie , że usiedli i nawet posnęli .
mam w zwyczaju	Ten zaprzecza , tłumacząc , że dopiero wczoraj po dziesięciu dniach wrócił do kraju : - Nie mam w zwyczaju telefonować z zagranicy i ustalać cen węgla - powiedział nam .
wziąć pod uwagę	Okazuje się , że głuchoniemi ciągną z tej działalności zyski , skromne wprawdzie , lecz wiele warte , jeśli wziąć pod uwagę , jak trudno znaleźć im normalnie płatną pracę .
mieć za złe	Nikt nie powinien mieć za złe autorowi , że mówi , co myśli .
przychodzi na świat	W Stanach Zjednoczonych co czwarte dziecko przychodzi na świat dzięki cesarskiemu cięciu .
jest w stanie	Jeśli istnieje coś , co jest w stanie zjednoczyć wszystkich Greków , niezależnie od tego , kim są i jakie wyznają poglądy , to jest to bez wątpienia problem Cypru .
rzuca się w oczy	W numerze wydanym przez Movex rzuca się w oczy kilkustronicowy wstępniak .
zamykać się w sobie	Po drugie , zadbaj , aby nie " zamykać się w sobie " i utrzymać kontakt ze swoimi uczuciami ( bądź świadomy swoich uczuć w związku z tą sytuacją ) .
brać pod uwagę	Jeśli brać pod uwagę ideologię , którą raczy nas od pół roku PiS i jego stabilizatory na temat np . wolności słowa , to na pewno nie .
na scenę wkroczył	Po tym orzeczeniu na scenę wkroczył Ogólnopolski Związek Zawodowy Lekarzy .
zdaję sobie sprawę	Nie mówiąc o tym , że staram się regularnie uczęszczać na analogiczne poranki moich kolegów i zdaję sobie sprawę , ile te spotkania zawdzięczają , gdy chodzi o ich klimat , osobistemu wkładowi prowadzącego je dyrektora Biblioteki .
wystąpienie z wnioskiem	To właśnie jego posłowie PiS winią za wystąpienie z wnioskiem o odznaczenie generała .
miał na celu	Z artykułu historyka Józefa Długosza , o uczniach kolegium w latach 1643 - 1670 : Lubomirski , fundując kolegium pijarów w Podolińcu , miał na celu szerzenie oświaty i przywrócenie katolicyzmu w miastach spiskich , które od 1412 roku należały do Polski .
mieli przed sobą	Jednak dalsze trwanie życia się wydłuża i za 40 lat , według prognoz demograficznych , Polacy w wieku 60 lat będą mieli przed sobą ( statystycznie rzecz ujmując ) niemal 24 lata życia , a w wieku 65 lat - niemal 20 lat .
jest na rękę	Być może taka sytuacja jest na rękę niezbyt sprawnym organom ścigania karnego .
doprowadzić do powołania	Zdaniem wybitnego prawnika nadanie nowych zadań dla KRS musiałoby musiało by doprowadzić do powołania nowej i kosztownej struktury , składającej się z sędziów wyłączonych z orzekania , którzy - w ocenie byłego I prezesa Sądu Najwyższego - wcześniej czy później wyalienowaliby wyalienowali by się od rzeczywistości w pracy wymiaru sprawiedliwości .
sobie nie życzę	Ja jako podatnik sobie nie życzę , żeby ktoś defraudował 500 milionów zł , a Stadion Dziesięciolecia czy Stadion Narodowy stał pusty za 800 milionów zł .
mysz nie prześliźnie się	- Nawet mysz nie prześliźnie się przez las Weipert .
zdawać sobie sprawę	- Państwo nareszcie zaczyna zdawać sobie sprawę , że nie potrafi sprawnie zarządzać ośrodkami zdrowia i że na racjonalnej prywatyzacji placówek skorzystają wszyscy - finanse publiczne , inwestorzy , a w szczególności pacjenci - twierdzi prof . Jacek Ruszkowski , dyrektor Centrum Zdrowia Publicznego Wyższej Szkoły Przedsiębiorczości i Zarządzania im . Leona Koźmińskiego w Warszawie .
Mamy do czynienia	- Mamy do czynienia z poważnym błędem w sztuce lekarskiej - oburza się , ale zastrzega , że o bezpośredniej przyczynie zgonu będzie się mógł wypowiedzieć dopiero po otrzymaniu oficjalnej ekspertyzy z Zakładu Medycyny Sądowej .
jest w stanie	Jego kosztów nie jest w stanie udźwignąć samodzielnie ani gmina , ani kopalnia " Bolesław Śmiały " .
stały pod znakiem	Czwartkowa noc i piątkowy ranek w regionie północno - wschodnim stały pod znakiem burz i silnego , porywistego wiatru .
zaprząta sobie głowy	Od dwóch tygodni ćwiczy z klasą kroki poloneza , natomiast nie zaprząta sobie głowy myślami o balowej kreacji .
tak się składa	Skoro jednak jestem za pluralizmem politycznym a tak się składa , że jestem , to wolałbym wolał by m , żeby partie i ugrupowania polityczne wchodzące w skład ruchu oporu były porządne i miały głowę na karku , a nie tylko gorące serca i dobre chęci ( do wykańczania konkurentów ) .
wchodzące w skład	Skoro jednak jestem za pluralizmem politycznym a tak się składa , że jestem , to wolałbym wolał by m , żeby partie i ugrupowania polityczne wchodzące w skład ruchu oporu były porządne i miały głowę na karku , a nie tylko gorące serca i dobre chęci ( do wykańczania konkurentów ) .
miały głowę na karku	Skoro jednak jestem za pluralizmem politycznym a tak się składa , że jestem , to wolałbym wolał by m , żeby partie i ugrupowania polityczne wchodzące w skład ruchu oporu były porządne i miały głowę na karku , a nie tylko gorące serca i dobre chęci ( do wykańczania konkurentów ) .
Było nie było	- Było nie było , bardzo dziękujemy i zabieramy wózek .
szły w górę	Już od pewnego czasu mówiło się , że spółki informatyczne są przewartościowane , a one ciągle szły w górę - mówi Benita Mikołajewicz , analityk ING Barings .
wprowadzenia do obrotu	Bez uszczerbku dla praw twórców lub artystów wykonawców , producentowi fonogramu lub wideogramu przysługuje wyłączne prawo do rozporządzania i korzystania z fonogramu lub wideogramu w zakresie : 1 ) zwielokrotniania określoną techniką , 2 ) wprowadzenia do obrotu , 3 ) najmu oraz użyczania egzemplarzy , 4 ) publicznego udostępniania fonogramu lub wideogramu w taki sposób , aby każdy mógł mieć do niego dostęp w miejscu i w czasie przez siebie wybranym .
zdaje sobie sprawę	Niewielu z nas zdaje sobie sprawę , że przeciwieństwie do nas - ludzi zwierzęta bardzo źle znoszą wybuchy sylwestrowych petard .
mlekiem i miodem płynącego	A do nas - kraju mlekiem i miodem płynącego - jakoś Ci głupi zniewoleni Amerykanie nie chcą imigrować za chlebem . ;-)))
rzuca się w oczy	Dlaczego kiedy premier Polski - tak jak premier Cimoszewicz przed kilkoma miesiącami - odwiedza Izrael , jedyne , co rzuca się w oczy , to stare waśnie i nieporozumienia , które czają się przy każdym punkcie programu wizyty ?
się palą ze wstydu	Niech się palą ze wstydu , gdy Polska będzie płacić Niemcom za prąd pochodzący z takiego źródła , jak właśnie elektrownie atomowe .
wcielić w czyn	Dlatego Wałęsa może dziś twierdzić , że " demokracja mu nie pozwoliła " wcielić w czyn paru zbawiennych pomysłów - choćby owych 100 milionów .
uderza po kieszeni	To również uderza po kieszeni polskiego rolnika , ale minister Jurgiel nie potrafi dogadać się z Rosjanami od listopada , a z Białorusią od końca stycznia .
mają na celu	Działania te , w które zaangażowane jest całe kierownictwo państwa , mają na celu uzyskanie jak najkorzystniejszych warunków członkostwa Polski w UE .
Chcąc nie chcąc	Chcąc nie chcąc , podjął się jednak leczenia w przychodni , mimo że specjalista uznał to za zbyt ryzykowne .
nie ma co	Dlatego nie ma co deliberować o tym , jak to będzie za tydzień , czy za kilka miesięcy .
dają za wygraną	Polscy producenci nie dają za wygraną , dotrzymując kroku modzie i zachodnim nowinkom .
przyjdzie do głowy	Metoda ta polega na dokańczaniu zaczętych zdań lub odpowiadaniu na pytania bez użycia intelektu , " pierwszą lepszą " myślą , która przyjdzie do głowy , np . Jestem zły , bo . . . ( odpowiedź ze sfery podświadomej ) drażni mnie zachowanie niektórych ludzi .
na końcu jeżyka pytanie	Miał już na końcu jeżyka pytanie , ile waży Diglator , ale nie chcąc się blamować ignorancją , wziął latarkę od Gossego i ruszył wzdłuż stopy olbrzyma .
mam na myśli	Ma obowiązek objawić rzeczywistość swoją i rzeczywistość swojego otoczenia , to znaczy tę , która wpływała na kształtowanie jego rzeczywistości , w tym wypadku mam na myśli naród - kończy Vilbert recytując to z powagą niby werset Pisma świętego w Wielki Piątek .
wejdzie w życie	Jeśli eksperyment powiedzie się , nowy przepis wejdzie w życie jeszcze przed mistrzostwami świata w USA - powiedział sekretarz generalny FIFA Sepp Blatter w wywiadzie dla belgijskiej gazety " Het Nieuwsblad " .
mającą na celu	- Jest natomiast proponowana uchwała decyzją doraźną , mającą na celu już dziś , teraz , ukrócenie praktyk prowadzących , jak dotąd , do wzrostu kosztów utrzymania .
poprzestanie na małem	Mąż Tomasza Międzika jest zadowolonym z siebie safandułą , którego dewizą jest " poprzestanie na małem " .
owijania w bawełnę	Dołączę się i ja do głosu Mathiasrexa , bez owijania w bawełnę : rodzice Lucpola powinni beknąć za to , że takie bzdury smarkacz wypisuje .
jest w stanie	Na obiedzie usłyszał em , że pewnej mojej prośby Cheng nie jest w stanie spełnić .
Bo ja wiem	Bo ja wiem . . . z moich znajomych może połowa .
ma do wyboru	" Unia ma do wyboru kilka opcji : od porzucenia projektu konstytucji poprzez próby ratyfikowania tekstu w obecnej formie , wyjaśnienia , lub uzupełnienia jego bieżącej wersji , zmianę obecnego tekstu celem jego poprawienia aż po gruntowne przeredagowanie tekstu " - czytamy w rezolucji .
weszła w życie	Umowa weszła w życie 1 czerwca 1994 r .
utrzymać w mocy karę	Iran zaprzeczył , jakoby sąd apelacyjny w Teheranie miał utrzymać w mocy karę śmierci , wymierzoną przez sąd niższej instancji niemieckiemu biznesmenowi , oskarżonemu o utrzymywanie stosunków seksualnych z irańską kobietą .
narażenie na niebezpieczeństwo	Kobiecie i jej partnerowi przedstawiono zarzuty " nieumyślnego spowodowania śmierci i narażenie na niebezpieczeństwo dziecka " .
korzystać z pomocy	We wsi nie ma masażysty , więc trzeba korzystać z pomocy najbliższych .
nosił w sobie	Krzesimir Dębski po obejrzeniu pierwszego montażu może wreszcie zacząć komponować muzykę , którą zresztą nosił w sobie od rozpoczęcia pierwszych zdjęć .
są w stanie	Dyrektorzy , nauczyciele , uczniowie mają wiele pytań , na które nie są w stanie uzyskać konkretnych odpowiedzi .
wystąpią w roli	Do przewodniczenia procesowi impeachmentu zaprzysiężono prezesa Sądu Najwyższego Williama Rehnquista i stu senatorów , którzy wystąpią w roli ławy przysięgłych .
zajście w ciążę	Natomiast dr Gręziak powiedziała wczoraj , że zapłodnienie pozaustrojowe - choć umożliwia zajście w ciążę - w ogóle nie jest leczeniem niepłodności .
wziąć w nawias	Ale spróbujmy wziąć w nawias całą dotychczasową wiedzę o Wieniawie i spojrzeć na niego tak , jakby śmy dysponowali tylko tą najnowszą książką .
Miała za sobą	Miała za sobą ciężki dzień .
stanęły przed oczami	Tym razem chyba wszystkim stanęły przed oczami obrazy z walki Gołota - Lewis .
zajmuje się sprawowaniem władzy	- Wiele tysięcy osób w Polsce udaje , że zajmuje się sprawowaniem władzy za pieniądze podatników - uzasadnia konieczność cięć Donald Tusk .
nie ma co	Po jego śmierci Jadzia uznała , że nie ma co , w łapę i tak nie da , a bez tego prędzej człowiek strzeli w kalendarz , niż dostanie numer ; zresztą do kogo , pytała retorycznie , miałaby miała by dzwonić i na jakie telefony czekać , skoro skończyła na tym bocianim gnieździe samotna i opuszczona .
strzeli w kalendarz	Po jego śmierci Jadzia uznała , że nie ma co , w łapę i tak nie da , a bez tego prędzej człowiek strzeli w kalendarz , niż dostanie numer ; zresztą do kogo , pytała retorycznie , miałaby miała by dzwonić i na jakie telefony czekać , skoro skończyła na tym bocianim gnieździe samotna i opuszczona .
skierowała akt oskarżenia	Sprawę prowadziła Prokuratura Rejonowa w Pruszczu Gdańskim , która skierowała akt oskarżenia przeciwko Marianowi P . do Sądu Rejonowego w Gdańsku .
nie ma co	Chyba nie ma co liczyć na grad medali .
leży w rękach	Teraz ich los leży w rękach wojewody .
wychodzi z siebie	Matka wychodzi z siebie : krzyczy , czasem szarpnie .
dostał w nagrodę	Za sportowe audi , jakie dostał w nagrodę , musiał by zapłacić 5 proc . cła , 22 proc . VAT-u i 6,4 proc . akcyzy .
przebywają na wakacjach	Pieniądze będą wykorzystane na zakup ubrań i przyborów szkolnych dla siedmiorga dzieci powodzian z Sokolnik , które przebywają na wakacjach w Górze .
powołano do życia	W celu rozpatrywania sporów dotyczących czynszów najmu i dzierżawnych powołano do życia 12 sądów ds . czynszów najmu i drugie tyle ds . czynszów dzierżawnych .
kłamał jak z nut	Podczas wyborów prezydenckich w 1995 r . Kwaśniewski kłamał jak z nut , że jest magistrem .
wyszły na jaw	Po krótkim dochodzeniu wyszły na jaw związki z kradzieżą rzeźb dokonaną w styczniu z kościoła w Limanowej .
staną na ślubnym kobiercu	Zanim jednak staną na ślubnym kobiercu , podpiszą umowę , według której w przypadku rozwodu każde z nich zachowa prawo do swojego majątku .
zajść w ciążę	Ale prezenterka nie wiedziała , kiedy miałaby miała by zajść w ciążę , bo to mogło pokrzyżować jej plany zawodowe .
będzie w stanie	- Ilekroć pan minister będzie w stanie wykonać cięcia budżetowe i przesunąć te pieniądze na służbę zdrowia , to będziemy popierać z entuzjazmem - mówi Rokita .
Nie ma co	Nie ma co udawać - akurat polską prawicą gardził wyjątkowo .
wejścia w życie	Im starsza w dniu wejścia w życie reformy była osoba , tym wyższy będzie jej kapitał początkowy .
weszło w życie	Z nowym rokiem weszło w życie nowe prawo dewizowe .
jak ognia unika	Pani sędzia jak ognia unika dziennikarzy .
spowodowane starzeniem się	Ponieważ w przyszłości prognozowane jest zmniejszenie się liczebności siły roboczej , spowodowane starzeniem się społeczeństwa , prawdopodobnie wskaźnik waloryzacji kont w dalszej perspektywie będzie niższy od wzrostu przeciętnego wynagrodzenia .
mamy do czynienia	- Z całą odpowiedzialnością stwierdzam , że mamy do czynienia z bardzo poważnym kryzysem wewnątrz koalicji - powiedział wczoraj na spotkaniu z dziennikarzami Jerzy Osiatyński , poseł na Sejm .
Przygadywał kocioł garnkowi	Przygadywał kocioł garnkowi , tyś ty ś też tylko o dziewczyny się wystarał - zganiła żartem męża Alicja Szkaradkowa .
Do złudzenia przypomina	Do złudzenia przypomina to działania policji Dorna wobec pokojowo wiecujących w Poznaniu .
bierze pod uwagę	- Policja nie mogła dopuścić do nie kontrolowanego rozwoju wydarzeń mając informacje , że każda ze stron bierze pod uwagę siłowe rozwiązania - mówi nadkomisarz Dariusz Nowak z krakowskiej policji .
mam w dupie	- Oczywiście , mam w dupie twoje zdrowie - wypalił obojętnie Zygmunt .
się zrobić wrażenie	Przewróciła oczyma w stronę baru , starając się wyglądać na osobę wyrafinowaną i znudzoną , lecz udało jej się zrobić wrażenie licealistki na balu .
wyszedł na wolność	Za kratami spędził 10 lat i wyszedł na wolność w 1995 .
poszło w zapasy	Miał on fajnych juhasów , ale pewnego razu dwóch z nich o coś się powadziło , poszło w zapasy i . . . słabszy wyzionął ducha .
wziąć pod uwagę	Trzeba jednak wziąć pod uwagę , że Kosowo wchodziło w skład państwa serbskiego tylko w XIII i XIV w . , a w tym stuleciu po wojnach bałkańskich w latach 1912 - 13 .
wchodziło w skład	Trzeba jednak wziąć pod uwagę , że Kosowo wchodziło w skład państwa serbskiego tylko w XIII i XIV w . , a w tym stuleciu po wojnach bałkańskich w latach 1912 - 13 .
dają o sobie znać	Ale oko malarza i zmysł piękna dają o sobie znać w zupełnie innych okolicznościach .
postawiono w stan	Służby mundurowe postawiono w stan podwyższonej gotowości .
Pasował jak ulał	Pasował jak ulał na papieża antysztuki .
Biorąc pod uwagę	Biorąc pod uwagę rozmiary bezrobocia , promocję ich rozwoju uznać należy za priorytet w polityce gospodarczej .
przyjściu na świat	Dziecko po przyjściu na świat jest kładzione mamie na brzuch na 1 - 3 minuty , a w ciągu 2 godzin przystawiane do piersi .
wprawianego w ruch	- Skoro sama dynamika lodu wprawianego w ruch przez coraz cieplejszą wodę oceaniczną , a nie jego topnienie od góry , może zdecydować o tym , jak bardzo skurczy się Antarktyda , to znaczy , że nasza zdolność przewidywania przyszłości jest ograniczona , ponieważ o tym zjawisku wiemy bardzo mało .
weszła w życie	W styczniu ubiegłego roku weszła w życie reforma administracyjna kraju , która podzieliła Polskę na nowe województwa oraz powiaty .
przebywające na urlopach	Posłowie wprowadzili jednak zapis , że z urlopów na starych warunkach będą mogły skorzystać nie tylko kobiety już przebywające na urlopach , ale także te , które 1 stycznia były w ciąży , o ile zwrócą się o to do pracodawcy .
dochodzą do wniosku	Oprócz znanych , przeważnie zagranicznych firm , które posiadają w Polsce własną sieć sklepów , coraz częściej z tego typu ofertą wychodzą do klientów również niewielkie , pojedyncze sklepy , których właściciele dochodzą do wniosku , że nie powinni pozostawać w tyle za konkurencją .
pozostawać w tyle	Oprócz znanych , przeważnie zagranicznych firm , które posiadają w Polsce własną sieć sklepów , coraz częściej z tego typu ofertą wychodzą do klientów również niewielkie , pojedyncze sklepy , których właściciele dochodzą do wniosku , że nie powinni pozostawać w tyle za konkurencją .
Tak mi dopomóż Bóg	Tydzień temu dyskutowaliśmy dyskutowali śmy o aborcji i o tym , żeby nie zabijać , a żołnierz , rekrut składający przysięgę wojskową , mówiący na końcu : ˝ Tak mi dopomóż Bóg ˝ , powinien mieć świadomość , że musi zabijać .
odpowiadać przed sądem	Chłopcy będą odpowiadać przed sądem jak dorośli .
W ogniu stanęły	W ogniu stanęły obiekty , w których mieściła się hurtownia obuwia .
przyjścia z pomocą	Wspólna ma być również ćwiczebna operacja przyjścia z pomocą tonącemu okrętowi .
nie ma co obrażać się	- Ale nie ma co obrażać się na rzeczywistość , tylko trzeba spośród tych ofert wybrać najlepsze .
przeszedł do historii	Papieżem , który przeszedł do historii jako wyjątkowo sprawny finansista , był Sykstus V , panujący w latach 1585 - 1590 .
Przed sądem postawiono	Przed sądem postawiono około 20 osób i byli to sami wojskowi .
jest na rękę	A to jest na rękę PiS-owi .
ma sobie równych	O starszej z sióstr mówi się , że jest wielkim talentem , w swojej kategorii wiekowej ( juniorka młodsza ) nie ma sobie równych , z powodzeniem rywalizuje z juniorkami i seniorkami .
była na nogach	Cały dzień była na nogach - widziała wszystko , co działo się dokoła , i to ona właściwie zajmowała się domem .
ma za zadanie	Pacjent ma za zadanie sprawdzić , czy wymienione na liście substancje lub przedmioty rzeczywiście wywołują u niego reakcję chorobową .
zbiegnie się w czasie	- Planując przetarg , nie wiedzieliśmy wiedzieli śmy , że jego koniec zbiegnie się w czasie z wyborami - broni siebie i ministra Marek Grabarek , prezes PLL LOT .
Zapierające dech w piersiach	Zapierające dech w piersiach akrobacje lotnicze w wykonaniu Sebastiana Chrząszcza były ozdobą Święta Lotnictwa , które w niedzielę obchodzono w Aeroklubie Opolskim .
wiążemy koniec z końcem	Czarterujemy też nasze dwa jachty zaprzyjaźnionym klubom i tak jakoś wiążemy koniec z końcem — powiedział komandor klubu „ Gwarek ” Bodo Gorus .
nie dała po sobie poznać	Niewierny mąż , wierny towarzysz zmarł z dnia na dzień , nagle , nie dała po sobie poznać , że to ją obeszło , ba , że to w ogóle było , jakby chciała zatrzeć dziwność , śmieszność czy nawet nierzeczywistość tego prędkiego przyjścia i nagłego zejścia .
Nie ma co	Nie ma co płakać .
podają w wątpliwość	Obok bowiem znacznej srogości w wymierzaniu kar za czyny niewątpliwie udowodnione , sędziowie przysięgli z zapałem zagłębiają się w szczególiki dowodów przeprowadzanych na rozprawie , a ich odmienne doświadczenie życiowe sprawia , że podają w wątpliwość , a nawet negują wiele źródeł rzeczowych , sposobów ich badania , opinii biegłych i zeznań świadków .
oddano do użytku	W listopadzie 1980 oddano do użytku nowe organy , zbudowane wg najdoskonalszych tradycji baroku przez firmę Gregor Hradetzky , Krems ( Austria ) .
wpadła na pomysł	W roku 1991 podczas kolacji Linda wpadła na pomysł , by powtórzyć i dokończyć lot Amelii : tak jak Amelia , w Elektrze z 1935 roku wystartuje z Oakland w Kalifornii i powróci w to samo miejsce po okrążeniu świata .
przyjmuje do wiadomości	Przewodniczący obradom ministrów Duńczyk Thor Pedersen odpowiedział , że przyjmuje do wiadomości postulaty krajów kandydujących , ale że " nie jest to odpowiednie forum do negocjacji członkowskich " .
dał do zrozumienia	Stwierdził , że aktualnie inwestycje Allianzu są za bardzo skoncentrowane na akcjach niemieckiego indeksu giełdowego DAX 30 , i dał do zrozumienia , że grupa będzie chciała pozbyć się papierów niektórych niemieckich spółek .
są w stanie	Do fatalnego w skutkach opóźnienia doszło - jak twierdzą sędziowie , z powodu zakorkowania warszawskiego sądu rejonowego tysiącami spraw , których wydziały nie są w stanie rozpatrzeć .
poszły w świat	Listy . . . poszły w świat , były tłumaczone na kilkanaście języków , nawet na chiński , śmiać mi się chciało , kiedy dostałam dostała m egzemplarze autorskie , gdzie zamiast liter były same robaczki .
pogrążona w żałobie	Cała szkoła jest pogrążona w żałobie - opowiada dziewczynka .
Oddanie do użytku	Oddanie do użytku domków w Połańcu w październiku 1997 r . było wyjątkowo uroczyste .
ma szansę otrząsnąć się	Kobieta przez wieki tłamszona , przygniatana na sto sposobów , brzydząca się przemocą i ulegająca jej , gwałcona , molestowana i poniżana w swej kobiecości i człowieczeństwie , wyuczona fałszu , manipulująca sobą , kobietami i mężczyznami , by przetrwać , wreszcie ma szansę otrząsnąć się z plwocin , jakie do niej przylgnęły przez wieki , może nie pozwalać na poklepywanie się po tyłku i podszczypywanie , będzie umiała się obronić przed brutalami i zyska wolny wybór stylu życia .
nie ma co	Wtedy pomyślałem pomyślał em : zawsze sobie coś znajdzie , żeby się szamotać , nic go nie zmieni , nawet nie ma co próbować .
klną na czym świat stoi	Ludzie klną na czym świat stoi i zostawiają samochody na ulicy , blokując połowę jezdni .
ani przez myśl	Oglądał em w telewizji , jak zatrzymywali Wieczerzaka i ani przez myśl mi nie przeszło , że jestem zamieszany w podobną aferę .
mamy do czynienia	Moim zdaniem , mamy do czynienia albo z próbą wywołania kryzysu w Sejmie , aby zmusić ewentualnych sojuszników do działań pod dyktando PiS , albo z dążeniem do przedterminowych wyborów .
nie ma czego do garnka włożyć	Przeciętny Polak mógłby mógł by się oburzyć : z czego się cieszyć , skoro on nie ma czego do garnka włożyć ? - zauważa prof . Edmund Wnuk - Lipiński .
biorąc pod uwagę	Po wielu meczach wyjazdowych Obra zbiera niezwykle pochlebne recenzje , ale to niewielka pociecha , biorąc pod uwagę , że liczą się przede wszystkim punkty .
ma w pogotowiu	Ściągnęła sobie już coś do picia , coś do pogryzania , ma w pogotowiu telefon i łączy się czatem ze swoją psiapsiółką , która też będzie oglądać tego lajwika u siebie w domu .
wyszła za mąż	Toteż usłuchawszy go , rzuciła studia , uciekła od rodziców do profesorskiego domu , wkrótce wyszła za mąż za wykładowcę i urodziła dzieci .
zdają sobie sprawę	Kierowcy zdają sobie sprawę z tego , że droga hamowania na zimowych oponach jest dużo krótsza , a zimą znacznie rzadziej wpada się na nich w poślizg - mówi Zbigniew Zaława , właściciel szkoły jazdy w Kielcach .
Wyszedł z założenia	Wyszedł z założenia , że wskazane przez Sellina przepisy ustawy o radiofonii i telewizji - mające stanowić podstawę do wystąpienia o informacje na temat przynależności partyjnej członków zarządów publicznych mediów - takiego prawa nie dają .
pluli sobie w brodę	Kto , jak nie on , zbił na skajowych portmonetkach fortunkę , podczas gdy inni pluli sobie w brodę , że studia mieli , dyplomy srakie-takie , a na ten prosty pomysł nie wpadli ?
nie ma mowy	W moim przypadku nie ma mowy , żeby m z jakiegokolwiek powodu znów zaczął grać .
będzie w stanie	- Nie ma wątpliwości , że dla takiego banku jak Handlowy , skupionego na pewnej grupie klientów , nie jest bez znaczenia , czy będzie w stanie przekształcić się w bank uniwersalny , świadczący usługi zarówno dla przedsiębiorstw , jak i dla ludności .
wyszło z mody	Właśnie teraz , kiedy opalanie już dawno wyszło z mody , potrzebuje ich twoja skóra , oczy , usta , a także włosy , abyś aby ś latem promieniała ciepłymi , opalizującymi kolorami natury .
wodził za nos	Pochodzący z Rumunii ślusarz wodził za nos policję i dyrekcję niemieckiej filii szwajcarskiego koncernu żywnościowego Nestle , podrzucając do sklepów na terenie Niemiec zatrute cyjanowodorem ( kwasem cyjanowodorowym zwanym też pruskim ) sosy , musztardę i majonez marki Thomy .
był w stanie	Wszyscy jednak wiedzą , że odejście junty było skutkiem kompromisu i że przez to Karamanlis nie był w stanie dokonać katharsis .
ma za zadanie	W ostatnich dniach do parlamentu trafił także rządowy projekt zmiany ustawy o banku centralnym , który ma za zadanie dostosować nasze prawo do regulacji obowiązujących w Unii Europejskiej .
wije się jak piskorz	Bayerische HypoVereinsbank wije się jak piskorz , by nie ogłaszać publicznego wezwania inwestorów do sprzedaży akcji BPH .
mają w nosie	Choć , jak podkreśla , kocha zwierzęta , nie kocha tych , którzy mają w nosie jego dom , ogród i jego prawo do czystego trawnika .
wprowadzającą w błąd	środki ochrony przed wprowadzającą w błąd reklamą i prezentacją towaru ( dyrektywa 84 / 450 zawierająca minimalny standard ; dyrektywa 87 / 367 dotycząca produktów , które wyglądają na inne , niż są w istocie , i tym samym stwarzają zagrożenie dla zdrowia i bezpieczeństwa konsumenta ) .
mają nadzieję wejść w koalicję	Ugrupowania , które mają nadzieję wejść w koalicję z PiS , zachowały natomiast wstrzemięźliwość w jego krytykowaniu , a Andrzej Lepper wygłosił nawet płomienną obronę i budżetu , i rządu .
leżą na ulicy	Jeśli zatem jeszcze kiedyś natkniesz się na promocję gminy czy miasta w stylu : " Inwestujcie u nas ! Tu pieniądze leżą na ulicy ! " to już wiesz o co chodzi .
Daję sobie radę	Daję sobie radę ze sobą .
wydaje się być	Taka postawa wydaje się być bardzo na rękę 19-letniemu " Panasiowi " .
Ma prawo zajmować się	Ma prawo zajmować się kwestiami faktycznymi i prawnymi .
legły w gruzach	Marzenia legły w gruzach , bo jest karany - płacze ojciec Dominika .
Czy się stoi czy się leży	Do wyjątków należą wierszowane kawały w rodzaju stwierdzenia : Czy się stoi czy się leży tysiąc złotych się należy .
nie wiedzieć czemu	A i " Machiny " nie wiedzieć czemu uważanej przez branżę prasową i reklamową za tytuł bardzo atrakcyjny dla fanów rocka .
spróbuję swoich sił	- Dopiero kiedy skończyłam skończyła m szkołę średnią , pomyślałam pomyślała m , że może spróbuję swoich sił na serio - mówi .
nabici w butelkę	" Zostaliśmy Zostali śmy nabici w butelkę jak słoń wepchnięty do niej podstępem i bujany w środku za ogon " - pisze redakcja .
miały prawo ubiegać się	Zgodnie z nowym prawem małżeństwa gejowskie , tak jak pary heteroseksualne , będą miały prawo ubiegać się o adopcję dzieci ( mogą to jednak być dzieci tylko narodowości holenderskiej , by uniknąć konfliktów z zagranicznymi organizacjami adopcyjnymi ) .
mają za sobą	Wszystkie otwarte fundusze emerytalne mają za sobą prawie dwa i pół roku działalności inwestycyjnej , a większość z nich zbliża się do trzyletniego okresu inwestowania naszych emerytalnych składek .
wpadający w ucho	Mimo to i w sentymentalnych komedyjkach dla pensjonarek trafiały się czasem pomysłowe sceny , a nadto jakiś łatwo wpadający w ucho kawałek muzyczny .
wyprowadził w pole	Jeśli zawarty związek nie znaczy nic dla partnera , jeżeli oszukał , grał , ukrywał , za nic miał zaufanie , kłamał w żywe oczy , wyprowadził w pole , zadrwił za plecami , nie dotrzymał układu , cichcem i podstępnie przestał być partnerem , to znaczy , że nie ma nic pewnego , znowu jest się samym , porzuconym , posiadanie stronnika było tylko złudzeniem , jest się na tym świecie obcym pomiędzy obcymi , odrzuconym , niechcianym .
mam przed sobą	Rzut oka na " Mawsu'at al-Jihad al-Afghani " ( oryginalny arabski tytuł encyklopedii ) wystarczył , bym by m zrozumiał , że być może mam przed sobą klucz do poznania sekretów organizacji Osama bin Ladena , najgroźniejszego terrorysty świata , odpowiedzialnego m.in . za wspieranie mudżahedinów i zamachy bombowe na ambasady amerykańskie w Afryce w 1998 roku .
doprowadzili do rozłamu	Adams odpowiedzialnością za tę porażkę obarczał Hamiltona i jego ludzi , którzy doprowadzili do rozłamu wśród federalistów .
da się zawrócić kijem	Biegu historii nie da się zawrócić kijem i pewne symbole muszą w niesławie odejść , a że z naszej świadomości odchodzą nieraz bardzo wolno , to potwierdza zdjęcie wejścia przy jednym z bloków wspomnianego przed chwilą osiedla , gdzie , jak widać , Nowotko wiecznie żywy .
przejdzie do historii	Piłkarze PSG zafundowali fanom spektakl , który przejdzie do historii francuskiego futbolu .
przedstawiono zarzut nieudzielenia pomocy	Nie przyszedł również st . sierżant Robert K . , któremu przedstawiono zarzut nieudzielenia pomocy rannemu chłopcu .
Nie ulega wątpliwości	Nie ulega wątpliwości , że dalszy spadek inflacji to najlepszy sposób na wychodzenie z recesji .
podawane do wiadomości	Decyzję władczą cechują , że : 1 ) podejmowane są w sposób sformalizowany , 2 ) przypisywane są określonemu organowi , 3 ) są w odpowiedni sposób podawane do wiadomości , 4 ) mają moc powszechnie obowiązującą .
na swoim koncie ma	- W czasach , gdy Andrzej Lepper i Leszek Miller wyrastają na mężów stanu , pole do działania dla satyryków jest ogromne - mówi Piotr Lisiewicz , dziennikarz " Gazety Polskiej " , lider Akcji Alternatywnej Naszość , która na swoim koncie ma wiele artystycznych osiągnięć i niemal tyle samo procesów sądowych , które same przerodziły się w happeningi .
skakaniem przez płótki	Ponadto , zajęci skakaniem przez płótki i graniem w siatkówkę , niewiele rozumieli z tego , co się wokół nich dzieje .
powołali do życia	Samorządowcy dwa miesiące temu powołali do życia Mokotowski Ośrodek Pomocy Uzależnionym .
w grę wchodził ulatniający się	W dwóch przypadkach konieczny był przyjazd brygady sieciowej , kiedy w grę wchodził ulatniający się gaz z podziemnych rur .
mrożących krew w żyłach	Nie obyło się bez mrożących krew w żyłach sytuacji .
da się przeprowadzić	Zdaje on sobie sprawę , że bez reprywatyzacji nie da się przeprowadzić skutecznych reform własnościowych .
Stojący pod znakiem zapytania	Stojący pod znakiem zapytania występ łódzkiej grupy Blue Cafe jednak doszedł do skutku i to z sukcesem .
doszedł do skutku	Stojący pod znakiem zapytania występ łódzkiej grupy Blue Cafe jednak doszedł do skutku i to z sukcesem .
jest w stanie	Czy mózg jest w stanie zrozumieć mózg ?
oddać w ręce	Ursuska " S " chce większą część udziałów , które dziś ma skarb państwa ( ok . 60 proc . ) , oddać w ręce spółki pracowniczej .
wił się jak piskorz	Michał Koniecpolski wił się jak piskorz , bladł jak papier , czerwieniał jak burak , bredził jak Piekarski na mękach .
Nie ma co	Nie ma co marzyć na razie jeszcze o tym , by kino europejskie przelicytowało amerykańskie sukcesy , w konkursie jednak filmy ze Stanów Zjednoczonych nie będą wcale przeważać .
się w głowie	- Serce waliło mi jak młotem , kręciło mi się w głowie i traciłam traciła m kontrolę nad sobą .
jest w stanie	Prezes Polskiej Miedzi twierdzi , że firma jest w stanie obniżać koszty o 4 - 5 proc . rocznie .
miał przed sobą	Nie zawsze mamy możliwość dokonania takiego eksperymentu w całości , ale nawet ograniczenie się do gry wyobraźni i zadanie sobie pytania : co bym by m zrobił , gdybym gdyby m miał przed sobą rok życia , a następnie zapisanie tego , co serce dyktuje , mogłoby mogło by się stać okazją do sprawdzenia , czy potrzebne są nam jakieś zmiany w bieżącym życiu .
weź pod uwagę	Jednak , dokonując wyboru , weź pod uwagę nie tyle rozmach przedsięwzięcia czy początkową głębokość zmiany , ile szansę realizacji .
mają na swoim koncie	Gangsterzy mają na swoim koncie zabójstwa , wymuszenia , kradzieże , handel i przemyt narkotyków .
nosi w sobie	Nawet profesor nosi w sobie gówno .
przed faktem dokonanym	Postawić Ministerstwo Sprawiedliwości przed faktem dokonanym , skruszyć obawę ministerstwa przed działaniem bardziej dynamicznym .
weszła w życie	- Należy podjąć wszelkie wysiłki , aby konstytucja weszła w życie w 2009 r . - zaapelowali eurodeputowani .
tworzeniu wartości dodanej	Jednak drobna przedsiębiorczość pod względem udziału w zatrudnieniu , tworzeniu wartości dodanej brutto , wydajności pracy czy rentowności powoli upodobnia się do europejskiej , choć pozostały jeszcze pewne cechy odrębne .
Dochodzę do wniosku	Dochodzę do wniosku , że w Sejmie to nie są przedstawiciele narodu , a gromada głupców handlujących między sobą stanowiskami .
stanęły przed oczami	Tym razem chyba wszystkim stanęły przed oczami obrazy z walki Gołota-Lewis .
wprowadzającymi w błąd	ochronę przed fałszywymi i wprowadzającymi w błąd informacjami w zakresie etykietowania towarów ( dyrektywa 79 / 112 , zm . 86 / 187 , 89 / 395 , 93 / 102 , w sprawie oznaczania towarów żywnościowych , uzupełniona dyrektywą 90 / 946 o dobrowolnym zamieszczaniu informacji o wartościach odżywczych na środkach spożywczych , a także dyrektywa 89 / 622 dotycząca oznakowania wyrobów tytoniowych ) ;
Zbita z tropu uśmiechnęła się	- Zbita z tropu uśmiechnęła się niepewnie .
Deklaracje złożenia podpisów złożyli	Deklaracje złożenia podpisów złożyli przedstawiciele komitetów Mirosława Pawlaka i Bolesława Tejkowskiego .
mając na uwadze	My natomiast uważamy , mając na uwadze doświadczenia pastora , że takie referendum powinno koniecznie się odbyć .
nie życzę sobie	Sam uważam się za człowieka lat 70 . , ale nie życzę sobie , by ktokolwiek czynił mi z tego powodu zarzut .
nie ulega wątpliwości	Odpowiedzi jest zapewne wiele , ale jedno nie ulega wątpliwości - praca ta wymaga ogromnego zaangażowania , na które obciążone prowadzeniem domu kobiety rzadko kiedy mogą sobie pozwolić .
dawać do zrozumienia	Aspirant wyartykułował nieokreślony dźwięk , co miało dawać do zrozumienia , że nie chce mieszać się do sporu .
była w stanie	Sprzęt służący do wczesnego wykrywania raka piersi nie służy nikomu dlatego , że najpierw żadna ze spółek powstałych po prywatyzacji ZOZ nie była w stanie udźwignąć kosztów utrzymania tego aparatu , a potem , gdy władze miasta zdecydowały się przekazać go Świętokrzyskiemu Centrum Onkologii , Zakład Ubezpieczeń Społecznych zajął sprzęt na poczet długów ZOZ .
stanął na czele	Po nagłej śmierci Diora stanął na czele jego domu mody w 1957 r .
zdają sobie sprawę	Sygnatariusze listu zdają sobie sprawę , że koszty utrzymania Studia są duże i trochę późno myśli się o zreformowaniu tej instytucji .
szukaj wiatru w polu	Dlatego też bez zwracania większej uwagi wypiorą i wysuszą cienkie jak mgiełka majteczki , schnące mniej więcej trzy minuty , a wtedy szukaj wiatru w polu , głupi zazdrośniku .
był w stanie	Na szczęście Urząd Ochrony Konkurencji i Konsumentów od czasu do czasu karci instytucje finansowe za to , że " zapomniały " poinformować klienta o szczegółach oferty lub gwiazdka była tak mała , że żaden klient nie był w stanie jej zauważyć .
nie ma o czym mówić	Dopóki nie zostaną przekazane szczegółowe przepisy wykonawcze nie ma o czym mówić , a i tak wiadomo , że będą to informacje objęte tajemnicą .
wpadł na pomysł	Jak mówią w BBWR , to jego szef prof . Zbigniew Religa wpadł na pomysł , by przedsięwzięcie sfinansował Belweder .
nie spuszczał z oczu	Linda sprawnie nakrywała do stołu , a Blondyn nie spuszczał z oczu jej wąskich stóp opatulonych w grube skarpety .
stanie na czele	Podkreślił , że " to , kto stanie na czele PE , będzie się decydowało dopiero po wyborach " , które odbędą się w czerwcu 2009 r .
myślę , więc jestem	A potem mówi " myślę , więc jestem " .
wcielania w życie	Po tysiącu lat kreowany jest na patrona jednoczącej się Europy . Stary patron nowej Europy Relikwiarz świętego Wojciecha w Gnieźnie FOT . STANISŁAW CIOK EWA K . CZACZKOWSKA Życie św . Wojciecha znaczyły kryzysy i katastrofy . Niektórzy złośliwi są skłonni nawet powiedzieć , że jego życie było totalnym bankructwem - trafnie zauważył ksiądz Henryk Żochowski na spotkaniu Akcji Katolickiej . Miał być rycerzem , a został biskupem . Dwukrotnie opuszczał biskupstwo szukając azylu w Rzymie , lecz go stamtąd wyrywano pod groźbą ekskomuniki . Pod koniec życia został misjonarzem , ale nikogo nie nawrócił . Ten z pozoru " bankrut " w półtora roku po śmierci został kanonizowany . W roku 1000 u jego grobu w Gnieźnie spotkali się wojciechowy przyjaciel - cesarz niemiecki Otton III , legat papieża Sylwestra II i książę Bolesław Chrobry , z którego dworu wyruszył nawracać pogan . To właśnie podówczas postanowiono utworzyć w Gnieźnie arcybiskupstwo , kładąc podwaliny pod samodzielną organizację kościelną w Polsce , cesarz zaś uznał suwerenność naszego kraju , dzięki czemu Polska mogła czuć się partnerem w europejskiej rodzinie krajów chrześcijańskich . I oto niebawem , 3 czerwca , podczas papieskiej pielgrzymki u grobu św . Wojciecha odbędzie się kolejny zjazd . Tym razem najwyższy hierarcha Kościoła katolickiego spotka się z prezydentami kilku tzw . świętowojciechowych państw : Niemiec , Słowacji , Węgier , Litwy i Polski ( z powodów zdrowotnych zabraknie prezydenta Czech ) oraz z przedstawicielem prezydenta Rosji . Zjazd gnieźnieński w roku 1000 był jednym z elementów wcielania w życie ottonowskiej koncepcji cesarstwa opartego na federacji równouprawnionych ludów . Ten obecny - jak można przypuszczać - będzie głównie przypomnieniem wspólnych chrześcijańskich korzeni Europy Zachodniej i Wschodniej oraz postaci Wojciecha , który podróżując między jej częściami przenosił idee , przerzucał mosty . Szukanie tamtych korzeni Profesor Henryk Samsonowicz w wywiadzie dla " GW " powiedział , że przed tysiącem lat Wojciech nadawał się na świętego " jednoczącej się wówczas Europy " lepiej niż ktokolwiek inny . Czech z pochodzenia , wykształcony w Niemczech , był biskupem Pragi i mnichem benedyktyńskim , przyjacielem cesarza i znajomym papieża ; przebywał w Italii , odwiedził Francję , Węgry , Polskę ; zginął nawracając Prusów . Ale okazuje się , że i teraz , w XX wieku , gdy Europa po rozpadzie dwóch wrogich obozów ponownie się jednoczy i szuka wspólnych korzeni , można sięgnąć do św . Wojciecha i kreować go na patrona wspólnej Europy .
podał do wiadomości	Choć Sąd Lustracyjny nie podał do wiadomości , czy jednym z podejrzanych jest Janusz Tomaszewski , to już wczoraj rano w radiowym wywiadzie był o tym przekonany Marian Krzaklewski .
stanął w miejscu	Potem , gdy przekornie stanął w miejscu , opracowałem opracował em sobie szczegółowy rozkład zajęć .
jest w stanie	Czy pan prezes jest w stanie określić , kiedy zarząd telewizji , którego pan był członkiem , debatował na temat kształtu ustawy czy nad nowelizacją tej ustawy ?
mieć na uwadze	Wykorzystując oznaki lokalne do prognozy pogody należy mieć na uwadze , że wnioskowanie na podstawie tylko jednej oznaki zazwyczaj okazuje się błędne , bowiem prawdopodobieństwo trafnej prognozy jest tym większe , im większa jest liczba oznak wskazujących na ten sam charakter zmian stanu pogody .
nie życzy sobie	Urzędnik departamentu konsularnego i wychodźstwa w MSZ ( nie życzy sobie , żeby wymieniać jego nazwisko ) radzi : - Niech obie panie napiszą podania o umorzenie długu .
rzuty karne wykonywać	Pomysłodawca sugerujący , by rzuty karne wykonywać przed rozpoczęciem gry wychodzi z założenia , że zwycięzcą rywalizacji w meczu zakończonym remisem będzie zespół , który wygrał konkurs " jedenastek " .
wychodzi z założenia	Pomysłodawca sugerujący , by rzuty karne wykonywać przed rozpoczęciem gry wychodzi z założenia , że zwycięzcą rywalizacji w meczu zakończonym remisem będzie zespół , który wygrał konkurs " jedenastek " .
są w stanie	Niespotykanie obfite opady śniegu sprawiły , że stada , które są głównym źródłem utrzymania ludności wiejskiej , nie są w stanie się wyżywić .
wychodzi z siebie	Mimo że administracja Clintona wychodzi z siebie , aby nie zwracać uwagi na postępowanie Rosji w Czeczenii , Kongres podnosi coraz to nowe problemy w stosunkach z Moskwą .
Własnym oczom nie	Własnym oczom nie wierzyliśmy wierzyli śmy , kiedy wczoraj prezydent Lech Kaczyński ( 57 l . ) kroczył na spotkanie ze sportowcami .
postawione na jedną kartę	Wszystko zostało postawione na jedną kartę - albo my albo oni .
wchodzi w życie	Z dniem 1 sierpnia w Nowym Jorku wchodzi w życie rygorystyczne prawo , pozwalające nawet na . . . konfiskatę auta z tablicami dyplomatycznymi , które jest obciążone mandatami za parkowanie .
Z propozycją roli	Z propozycją roli mediatora w sprawie Stoczni Szczecińskiej wystąpił Uniwersytet Szczeciński .
ma na celu	Dr Stelągowski twierdzi , że uszczelnione sito opieki podstawowej ma na celu ograniczenie specjalistycznych świadczeń medycznych .
Odebrali sobie życie	Odebrali sobie życie 13 lutego i 13 marca .
wchodzący w skład	W piątek ( 3 bm . ) do świnoujskiego portu wojennego wpłynie zespół okrętów wchodzący w skład Sił Natychmiastowego Reagowania NATO .
miał wyrzutów sumienia	" Jankowski " , bo taki miał pseudonim , nie miał wyrzutów sumienia , donosząc na prymasa Wyszyńskiego , o . Ziębę , Jacka Kuronia i ks . Popiełuszkę .
mających za sobą	Już po raz drugi odbędzie się więc w Lublinie Otwarty Konkurs Fryzjerski dla młodych fryzjerów ( do lat 30 ) i uczniów mających za sobą przynajmniej 3 lata nauki zawodu .
wchodzących w skład	Za szkody wyrządzone w obwodach łowieckich - leśnych , odszkodowanie wypłacają Lasy Państwowe , a na terenach obwodów łowieckich - polnych i na terenach nie wchodzących w skład obwodów łowieckich - wojewodowie .
Jak się zwał , tak się zwał	- Jak się zwał , tak się zwał , byleby byle by się dobrze miał .
Tak się składa	Tak się składa , że obecnie czołówka Ministerstwa Sprawiedliwości dołączyła do opinii publicznej i naturalnie czerpie z tego korzyści propagandowe : nareszcie mamy ministra i prokuratora generalnego , który nie będzie się z przestępcami cackał !
oddać do użytku	Na przełomie czerwca i lipca Stomil - Olsztyn SA zamierza oddać do użytku budowany właśnie magazyn opon .
siada za kółkiem	Bardzo źle się dzieje , gdy coraz więcej kierowców siada za kółkiem po wypiciu alkoholu , jest zaś jeszcze gorzej , gdy to samo robią stróże porządku .
będzie w stanie	Być może Kwartet ( USA , ONZ , UE i Rosja ) z udziałem sił demokratycznych w społeczeństwie palestyńskim będzie w stanie to w części zrealizować .
nie ma co	Bo na dobroduszność szpitala matka Kamila nie ma co liczyć .
trzyma przy życiu	Co mnie trzyma przy życiu , to nadzieja , że wezmę odwet .
zdają sobie sprawę	Nie wszyscy pamiętający ten okres zdają sobie sprawę , iż amortyzatorem skutków terapii szokowej , skierowanej na uzdrowienie chorej gospodarki publicznej , byli ci " groszowi " drobni wytwórcy , uliczni handlarze , którzy rychło stali się właścicielami sklepów ( handel detaliczny został prawie w całości sprywatyzowany w ciągu 2-3 lat ) .
Bo ja wiem	– Bo ja wiem ? – Monte Cassino rozłożył bezradnie ręce .
puszczamy wodze wyobraźni	Zdaniem projektantów ( wolą być nazywani designerami ) pozwalamy sobie na odrobinę swobody i puszczamy wodze wyobraźni tylko w kuchni .
wziąć za pysk	Kończąc , Michał Zieliński pisze , że zamiast przełamywania liberalnego dogmatu nierówności " lepiej zgodnie z zaleceniem Stefana Kisielewskiego - po liberalnemu - wziąć za pysk " .
weszła w życie	Z nowym rokiem weszła w życie również ustawa o ochronie osób i mienia , która stawia przed osobami chcącymi pracować jako ochroniarze lub prowadzić agencję ochrony wyższe wymagania .
nie ma co	Na Dworcu oni dali innym cynk , że nie ma co wychodzić .
nie ma mowy	W oczywisty sposób jest to za mało , nie ma mowy o np . wspólnym analizowaniu i poprawianiu prac , o jakimkolwiek indywidualnym podejściu .
cierpiąca na zaburzenia	W niedzielę zaniepokojona rodzina z Krakowa zawiadomiła TOPR , że cierpiąca na zaburzenia psychiczne ich krewna , prawdopodobnie poszła w góry z zamiarem popełnienia samobójstwa .
W pale nie mieściło się	W pale nie mieściło się do tej pory , że techniki rozrodcze można skatalogować aż na tyle sposobów !
zarzut znęcania się	Przedstawiono mu zarzut znęcania się nad zwierzęciem .
zwróciły znajdujące się	Uwagę funkcjonariuszy gdyńskiego Urzędu Celnego zwróciły znajdujące się w pierwszych rzędach kontenera miski ceramiczne .
nie chcą słyszeć	Ormianie w ogóle nie chcą słyszeć o pozostawaniu częścią Azerbejdżanu .
przyjdą do głowy	- Na wstępie proszę o nieprzerywanie naszego spotkania , bo na 95 procent pytań , jakie Państwu przyjdą do głowy , padnie tu odpowiedź .
I to by było na tyle	- I to by było na tyle - stwierdziła bez żalu Marzena , wycierając jedną upapraną dłonią drugą , równie brudną .
uderzać pięścią w stół	Wydaje się , że jest radykalny i może zbyt często uderzać pięścią w stół , choć on deklaruje , że tak się nie stanie .
miał na myśli	Dziennikarze chcieli się koniecznie dowiedzieć , kogo Jelcyn miał na myśli w piątek w Jekaterynburgu , gdy oświadczył , że zna nazwisko przyszłego prezydenta Rosji po wyborach w 2000 r .
powołany na stanowisko	W roku 2001 został powołany na stanowisko kierownika Zakładu Filozofii Współczesnej Instytutu Filozofii UŁ .
nie ulega wątpliwości	Pilch : - Selekcjoner powinien mieć dobre warunki pracy , tymczasem nie ulega wątpliwości , że Engel tą porażką swoje warunki pracy mocno sobie utrudnił .
Nie ma co	Nie ma co się denerwować .
spodobało się mieć na własność	Teatr , o którym mowa , powstał w drugiej połowie lat 70 . dzięki sile perswazji jednego człowieka , któremu akurat spodobało się mieć na własność taką zabawkę , jak teatr satyry .
są w stanie	Z braku środków sądy nie są w stanie nabyć materiałów biurowych .
zaprzątał sobie głowy	Panował niebywały entuzjazm i z początku nikt nie zaprzątał sobie głowy pytaniem , jak ukarać członków junty - tym bardziej że oni sami woleli zejść ludziom z oczu .
składaniu w ofierze	Nie odprawiali więc czarnych mszy polegających na składaniu w ofierze szatanowi ludzi .
weźmiemy pod uwagę	Ponadto podkreślają oni - nonsensowność koncepcji teoretycznych , bazujących na takich poglądach staje się jeszcze bardziej wyrazista , jeśli weźmiemy pod uwagę sytuację zmian miejsca pracy .
wyszedł na jaw	Fakt , że 26-letni Krzysztof R . był bity przez żonę , wyszedł na jaw dopiero na rozprawie rozwodowej .
mam zamiaru afiszować się	- Wybaczy pan , nie mam zamiaru afiszować się z poglądami .
nie ma mowy	O oprocentowaniu rat nie ma mowy , ponieważ to wyznacza ustawa o gospodarce nieruchomościami .
zdają się odnosić	Tymczasem zaś , jak donoszą " Izwiestia " , zrozpaczeni wielomiesięcznym oczekiwaniem na wypłacenie zaległych zarobków górnicy Zagłębia Kuźnieckiego coraz przychylniej zdają się odnosić do zabójstwa na zamówienie jako nowego środka walki klasowej , zwłaszcza że Moskwa twierdzi , iż pieniądze dawno przekazała , a wina za zwłokę spoczywa na miejscowym kierownictwie .
nie ma się co spieszyć	Lider SLD Włodzimierz Cimoszewicz mówił kilka dni po wyborach , że z wejściem do NATO nie ma się co spieszyć , a Micewski uważał , że rozszerzenie Paktu na Wschód nie może odbywać się bez uzgodnienia z Rosją .
Biorąc pod uwagę	Biorąc pod uwagę te wymagania , do czerwca tego roku zarejestrowano w województwie śląskim 333 zagraniczne firmy .
wejść w życie	Konstytucja , aby wejść w życie , musiała być ratyfikowana przez legislatury stanowe .
się obawiać podejmowania ryzyka	Zbigniew Stypa , prezes Ship Service , uważa , że w takiej sytuacji wielu przedsiębiorców może się obawiać podejmowania ryzyka gospodarczego , gdyż np . może mieć obawy jak daną operację handlową potraktują organa karno - skarbowe .
doszli do wniosku	Po pierwszych oględzinach doszli do wniosku , że nie budzi zastrzeżeń .
w grę wchodzą	Zamoyski : Kiedy w grę wchodzą interesy , przyjaźnie się kończą .
będzie w stanie	Już wówczas Kukliński wspomniał , że nie będzie w stanie opłacić obowiązującego w Polsce podatku od darowizny .
wiąże koniec z końcem	W efekcie ledwo wiąże koniec z końcem i nigdy nie miała na koncie więcej niż parę tysięcy dolarów .
będą w stanie	" Inteligentne " systemy będą w stanie je właściwie zinterpretować i błyskawicznie zareagować , by uchronić samolot lub samochód przed katastrofą .
weszli w skład	Starosta makowski Kazimierz Białobrzeski i burmistrz miasta Tadeusz Ciak weszli w skład rady programowej projektu , który mówiąc najogólniej dotyczy gospodarowania odpadami .
przyszedł na świat	Tymczasem rodzice Sebastiana Kraszewskiego , który przyszedł na świat minutę po rozpoczęciu się 2000 roku w Wojewódzkim Szpitalu Specjalistycznym we Wrocławiu , otrzymali już od premiera Jerzego Buzka wózek dziecięcy i list gratulacyjny .
zapomniał języka w gębie	Spojrzała na niego z ulotnym zainteresowaniem , właściwie bez zainteresowania , jakby był ciemną , romantyczną zjawą wynurzającą się z odmętów tej letniej nocy , że zapomniał języka w gębie i bezmyślnie gapił się na jej słynny biust , na słynne blond włosy rozpłomienione warszawskim splinem , na tę estradową panterę opiętą kolorowo zawrotną spódnicą i kolorowymi tekstami jeszcze bardziej zawrotnych piosenek Agnieszki Osieckiej , choć Lakis już coś tam bajerował o międzyludzkich fluidach , które wydzielają te cudowne piosenki przy słuchaniu i śpiewaniu .
jest w stanie	Nic jednak nie jest w stanie przesłonić faktu , że chińsko - rosyjskie strategiczne partnerstwo to raczej " małżeństwo z rozsądku " skazanych na sąsiedztwo mocarstw i że za każdym deklarowanym sukcesem kryje się jakieś " ale " .
narazić na niebezpieczeństwo	W poniedziałek dowódca sił ONZ w Sarajewie gen . Herve Gobilliard wydał rozkaz , by jego oddziały " w żadnym wypadku nie podejmowały wobec stron działań mogących narazić na niebezpieczeństwo życie żołnierzy " .
stanąć na czele	Król Konstantyn , który nie chciał czy nie umiał stanąć na czele walki z reżimem , stracił doszczętnie sympatię narodu .
dajcie zielone światło	Jeśli jednak różnice te nie pozwalają wam zbudować takiego formalnego porozumienia , dajcie zielone światło do współdziałania ludziom tworzącym wasze ugrupowania .
wejdą w skład	Na nadzwyczajnej sesji plenarnej w Brukseli Parlament Europejski zatwierdził w sobotę zdecydowaną większością głosów wprowadzenie wspólnej waluty europejskiej euro w 11 krajach , które od 1 stycznia 1999 roku wejdą w skład unii gospodarczej i walutowej w ramach UE .
przyszło do głowy	Czasem pożyczamy obrazy na wystawy , ale nikomu tu nie przyszło do głowy , żeby je oddać .
dostał w swoje ręce	Gdyby tę panią Mary Mc . . . dostał w swoje ręce . . .
doprowadziły do zatrzymania	Kolejne czynności doprowadziły do zatrzymania dwóch sprawców kradzieży ( mieszkańcy podhajnowskich wsi ) oraz dwóch paserów .
Nie ma co się bawić	Prof . Robert Nowak : Nie ma co się bawić z Urbanem procesami o porno itd . , tylko trzeba wprowadzić ( . . . ) opodatkowanie o wiele ostrzejsze pism skandalizujących , takich jak » NIE « Urbana , takich jak » Zły « , redagowany przez żonę Urbana , uderzyć Urbana po kieszeni i on by to zrozumiał .
ładuje paluchów między drzwi	Niech pan nie ładuje paluchów między drzwi ! – tak do mnie powiedział .
mające na celu	W 1995 r . , w związku z reformą ( istniejącej od 1973 r . ) Komisji do Spraw Konsumentów ( 15 przedstawicieli państw członkowskich i 5 przedstawicieli organizacji konsumenckich ) , przedstawiono dokument przewidujący m . in . akcje : w zakresie usług finansowych na rzecz konsumentów ; w zakresie podstawowych usług publicznoprawnych na rzecz konsumentów ; mające na celu umożliwienie korzystania konsumentom z dobrodziejstwa społeczeństwa informatycznego ; mające na celu wzmocnienie zaufania konsumentów do produktów żywieniowych ; promocji konsumpcji przyjaznej środowisku naturalnemu ; pomocy dla krajów Europy Centralnej i Wschodniej przy kreowaniu ich polityki konsumenckiej .
mające na celu	W 1995 r . , w związku z reformą ( istniejącej od 1973 r . ) Komisji do Spraw Konsumentów ( 15 przedstawicieli państw członkowskich i 5 przedstawicieli organizacji konsumenckich ) , przedstawiono dokument przewidujący m . in . akcje : w zakresie usług finansowych na rzecz konsumentów ; w zakresie podstawowych usług publicznoprawnych na rzecz konsumentów ; mające na celu umożliwienie korzystania konsumentom z dobrodziejstwa społeczeństwa informatycznego ; mające na celu wzmocnienie zaufania konsumentów do produktów żywieniowych ; promocji konsumpcji przyjaznej środowisku naturalnemu ; pomocy dla krajów Europy Centralnej i Wschodniej przy kreowaniu ich polityki konsumenckiej .
Kto rano wstaje , temu Pan Bóg daje	Jej receptą na długowieczność jest nieobjadanie się ( twierdzi , że od stołu powinno się wstawać głodnym ) , niezbyt długie spanie ( " Kto rano wstaje , temu Pan Bóg daje " ) , zgodne życie w małżeństwie i dbałość o dzieci .
cierpiał na paraliż	Mówi , że jej zwierzęta nie były agresywne : Olka spała na fotelu w kuchni , Punia miała dziewięciodniowego szczeniaka , od którego nie odeszłaby odeszła by , a Kajtek cierpiał na paraliż tylnych łap .
na depresję cierpią	Żona pod opieką Psychiatry wyjątkowo sprawnie dochodzi do siebie , zwłaszcza od kiedy jej wytłumaczył , że ludzie tak naprawdę mogą mieszkać tylko w innych ludziach , depresja to nic innego , jak bezdomność , na depresję cierpią ludzie , którzy nie mają w kim mieszkać , a potem zaproponował , że otworzy przed nią swoje drzwi .
zamykają się w sobie	Anka : Rodziny alkoholików - przeciwnie , zamykają się w sobie , izolują od ludzi .
nie ma co się	Natomiast podobnego plebiscytu nie ma co się na razie spodziewać w Tadżykistanie .
Nie dam sobie w kaszę dmuchać	Nie dam sobie w kaszę dmuchać ! - przechwalała się junacko .
miał na myśli	ŻYCIU wyjaśnił , że miał na myśli tyle , iż żadne zmiany personalne nie są wykluczone , ale nie one są najważniejsze .
na nogach są	Na starym tankowcu M/s " Norsel " na nogach są tylko rosyjscy marynarze i pan Marek , polski kucharz , który znakomicie gotuje .
mając na widoku	Warto natomiast spojrzeć na europejską gospodarkę w latach 1988-2000 oraz jej prognozę do 2005 r . - mając na widoku mniej lub bardziej odległą przyszłość gospodarki polskiej .
daje za wygraną	- Ale ofiara może być dobrowolna - nie daje za wygraną młodsza .
z wnioskiem wystąpił	Nie zgodził się na to zarząd po tym jak z wnioskiem wystąpił Zakład Gospodarki Komunalnej i Mieszkaniowej .
obowiązek domagać się	Jako działacz związkowy , jako radny , mam prawo , ale i obowiązek domagać się odpowiedzi , bowiem w tej radzie zasiadam z wyboru mieszkańców Bydgoskiego Przedmieścia , ludzi biednych , bezrobotnych i często jeszcze zamieszkujących w lokalach piwnicznych .
przyjmuje do wiadomości	Bywa często , że nosiciel przyjmuje do wiadomości wyrok losu fragmentarycznie - w pewnych sytuacjach zachowuje się racjonalnie , w innych uprawia myślenie życzeniowe .
stawia pierwsze kroki	Czy kiedy po raz pierwszy szedł do Jacka Kuronia , śniło mu się , że właśnie stawia pierwsze kroki na drodze do najbardziej prestiżowej amerykańskiej nagrody dziennikarskiej - Pulitzera - którą otrzyma za swoje korespondencje z Polski w roku 1982 ?
za stosowne wtrącić się	Uważałem Uważał em za stosowne wtrącić się do rozmowy : - Iwona , zapominasz , że ja mogę cię wyrzucić .
przyłapanego na gorącym uczynku	- Czy policjanci powinni ścigać złodzieja przyłapanego na gorącym uczynku , czy poprzestać na zabezpieczeniu mienia ?
pranie brudnych pieniędzy	Zarzuca mu pranie brudnych pieniędzy , płatną protekcję i udział w zorganizowanej grupie przestępczej .
przyszły na świat	Zwierzęta przyszły na świat w październiku i zgodnie z obowiązującym w ośrodku zwyczajem , zostały ochrzczone .
na marne pójdzie	Sukienka podłużona tiulową falbaną , bo w ciągu miesiąca od kupna wyrosła z niej tyczka grochowa , już krzywo ma wianek z perełkami , w deszczu na marne pójdzie matki staranie .
biją na alarm	Demografowie biją na alarm - w Polsce rodzi się coraz mniej dzieci .
Mamy do czynienia	- Mamy do czynienia z ewidentną walką polityczną o kierownictwo Instytutu - powiedział .
tworzeniu wartości dodanej	Natomiast w tworzeniu wartości dodanej brutto udział polskich MSP jest mniejszy niż w UE , co tłumaczy się głównie różnicą w strukturze wydajności pracy .
szukać dziury w całym	Drodzy radni , może wreszcie pomyślicie o dobru społeczeństwa , zamiast na siebie patrzeć bykiem i szukać dziury w całym i powodów do tego , aby odpłacić pięknym za nadobne .
nie mamy co	- PSL jest partią dosyć skromną , a skoro AWS nie wystawiła jeszcze kandydata , nie mamy co wysuwać się przed szereg - tłumaczy zwłokę w wyłonieniu kandydata Franciszek Stefaniuk , wicemarszałek Sejmu i nowy szef Rady Naczelnej stronnictwa .
oddany do użytku	U wylotu ul . Mickiewicza przy Rynku Spółdzielczy Dom Handlowy " Skarbek " ( proj . J . Jarecki ) , oddany do użytku w styczniu 1975 .
przebywał na emigracji	Gdy stało się jasne , że to już koniec , prezydent Gizikis wezwał Konstantinosa Karamanlisa , jednego z czołowych polityków , który przebywał na emigracji w Paryżu .
doprowadzić do zaburzeń	Intensywne i długotrwałe stosowanie ( zwłaszcza na dużych powierzchniach ciała ) może doprowadzić do zaburzeń równowagi hormonalnej ( steroidy absorbowane są przez skórę ) .
ma przed sobą	Obecnie , osoba w wieku 60 lat przeciętnie ma przed sobą jeszcze niemal 19 lat życia , a w wieku 65 lat - nieco ponad 16 lat .
robi w konia	Ale jak zaufać policji , która robi w konia kandydatów na policjantów ?
